{
  "version": 1,
  "width": 20,
  "height": 20,
  "tilewidth": 32,
  "tileheight": 32,
  "orientation": "orthogonal",
  "tilesets": [
    {
      "name": "tileset",
      "image": "tileset.svg",
      "imagewidth": 128,
      "imageheight": 128,
      "tilewidth": 32,
      "tileheight": 32,
      "firstgid": 1,
      "tiles": [
        {
          "id": 0,
          "properties": {
            "collides": false,
            "type": "grass"
          }
        },
        {
          "id": 1,
          "properties": {
            "collides": false,
            "type": "dirt"
          }
        },
        {
          "id": 2,
          "properties": {
            "collides": false,
            "type": "stone"
          }
        },
        {
          "id": 3,
          "properties": {
            "collides": true,
            "type": "water"
          }
        },
        {
          "id": 4,
          "properties": {
            "collides": true,
            "type": "tree"
          }
        },
        {
          "id": 5,
          "properties": {
            "collides": false,
            "type": "path"
          }
        },
        {
          "id": 6,
          "properties": {
            "collides": true,
            "type": "chest",
            "interactive": true
          }
        },
        {
          "id": 7,
          "properties": {
            "collides": false,
            "type": "sign",
            "interactive": true
          }
        }
      ]
    }
  ],
  "layers": [
    {
      "name": "Ground",
      "width": 20,
      "height": 20,
      "data": [
        1, 1, 1, 1, 1, 1, 1, 1, 1, 1, 1, 1, 1, 1, 1, 1, 1, 1, 1, 1,
        1, 1, 1, 1, 1, 1, 1, 1, 1, 1, 1, 1, 1, 1, 1, 1, 1, 1, 1, 1,
        1, 1, 1, 1, 1, 1, 1, 1, 1, 4, 4, 1, 1, 1, 1, 1, 1, 1, 1, 1,
        1, 1, 1, 1, 1, 1, 1, 1, 1, 4, 4, 1, 1, 1, 1, 1, 1, 1, 1, 1,
        1, 1, 1, 1, 1, 1, 1, 1, 1, 6, 6, 1, 1, 1, 1, 1, 1, 1, 1, 1,
        1, 1, 1, 1, 1, 1, 1, 1, 6, 6, 6, 6, 1, 1, 1, 1, 1, 1, 1, 1,
        1, 1, 1, 1, 1, 1, 1, 6, 6, 6, 6, 6, 6, 1, 1, 1, 1, 1, 4, 1,
        1, 1, 4, 1, 1, 1, 6, 6, 6, 6, 6, 6, 6, 6, 1, 1, 1, 4, 4, 1,
        1, 4, 4, 1, 1, 1, 6, 6, 3, 3, 3, 3, 6, 6, 1, 1, 1, 4, 1, 1,
        1, 4, 1, 1, 1, 1, 6, 6, 3, 3, 3, 3, 6, 6, 1, 1, 1, 1, 1, 1,
        1, 1, 1, 1, 1, 1, 6, 6, 3, 3, 3, 3, 6, 6, 1, 1, 1, 1, 1, 1,
        1, 1, 1, 1, 1, 1, 6, 6, 3, 3, 3, 3, 6, 6, 1, 1, 1, 1, 1, 1,
        1, 1, 1, 1, 1, 1, 1, 6, 6, 6, 6, 6, 6, 1, 1, 1, 1, 1, 1, 1,
        1, 1, 1, 1, 1, 1, 1, 1, 6, 6, 6, 6, 1, 1, 1, 1, 1, 1, 1, 1,
        1, 1, 1, 1, 1, 1, 1, 1, 1, 6, 6, 1, 1, 1, 1, 1, 1, 1, 1, 1,
        1, 1, 1, 1, 1, 1, 1, 1, 1, 6, 6, 1, 1, 1, 1, 1, 1, 1, 1, 1,
        1, 1, 1, 1, 1, 1, 1, 1, 1, 6, 6, 1, 1, 1, 1, 1, 1, 1, 1, 1,
        1, 1, 1, 1, 1, 1, 1, 1, 1, 6, 6, 1, 1, 1, 1, 1, 1, 1, 1, 1,
        1, 1, 1, 1, 1, 1, 1, 1, 1, 6, 6, 1, 1, 1, 1, 1, 1, 1, 1, 1,
        1, 1, 1, 1, 1, 1, 1, 1, 1, 1, 1, 1, 1, 1, 1, 1, 1, 1, 1, 1
      ]
    },
    {
      "name": "Objects",
      "width": 20,
      "height": 20,
      "data": [
        0, 0, 0, 0, 0, 0, 0, 0, 0, 0, 0, 0, 0, 0, 0, 0, 0, 0, 0, 0,
        0, 0, 0, 0, 0, 0, 0, 0, 0, 0, 0, 0, 0, 0, 0, 0, 0, 0, 0, 0,
        0, 0, 0, 0, 0, 0, 0, 0, 0, 5, 5, 0, 0, 0, 0, 0, 0, 0, 0, 0,
        0, 0, 0, 0, 0, 0, 0, 0, 0, 0, 0, 0, 0, 0, 0, 0, 0, 0, 0, 0,
        0, 0, 0, 0, 0, 0, 0, 0, 0, 0, 0, 0, 0, 0, 0, 0, 0, 0, 0, 0,
        0, 0, 5, 0, 0, 0, 0, 0, 0, 0, 0, 0, 0, 0, 0, 0, 0, 0, 0, 0,
        0, 0, 0, 0, 0, 0, 0, 0, 0, 0, 0, 0, 0, 0, 0, 0, 0, 0, 5, 0,
        0, 0, 5, 0, 0, 0, 0, 0, 0, 0, 0, 0, 0, 0, 0, 0, 0, 5, 0, 0,
        0, 5, 0, 0, 0, 0, 0, 0, 0, 0, 0, 0, 0, 0, 0, 0, 0, 0, 0, 0,
        0, 0, 0, 0, 0, 0, 0, 0, 0, 0, 0, 0, 0, 0, 0, 0, 0, 0, 0, 0,
        0, 0, 0, 0, 0, 0, 0, 0, 0, 0, 0, 0, 0, 0, 0, 0, 0, 0, 0, 0,
        0, 0, 0, 0, 0, 0, 0, 0, 0, 0, 0, 0, 0, 0, 0, 0, 0, 0, 0, 0,
        0, 0, 0, 0, 0, 0, 0, 0, 0, 0, 0, 0, 0, 0, 0, 0, 0, 0, 0, 0,
        0, 0, 0, 0, 0, 0, 0, 0, 0, 0, 0, 0, 0, 0, 0, 0, 0, 0, 0, 0,
        0, 0, 0, 0, 0, 0, 0, 0, 0, 0, 0, 0, 0, 0, 0, 0, 0, 0, 0, 0,
        0, 0, 0, 0, 0, 0, 0, 0, 8, 0, 0, 0, 0, 0, 0, 0, 0, 0, 0, 0,
        0, 0, 0, 0, 0, 0, 0, 0, 0, 0, 0, 0, 0, 0, 0, 0, 0, 0, 0, 0,
        0, 0, 0, 0, 0, 0, 0, 0, 0, 0, 0, 0, 0, 0, 0, 0, 0, 0, 0, 0,
        0, 0, 0, 0, 0, 0, 0, 0, 0, 0, 0, 0, 0, 0, 0, 0, 0, 0, 0, 0,
        0, 0, 0, 0, 0, 0, 0, 0, 0, 0, 0, 0, 0, 0, 0, 0, 0, 0, 0, 0
      ]
    }
  ],
  "objects": [
    {
      "name": "PlayerSpawn",
      "type": "spawn",
      "x": 320,
      "y": 500,
      "width": 32,
      "height": 32,
      "properties": {
        "spawn": "player"
      }
    },
    {
      "name": "NPC1",
      "type": "npc",
      "x": 320,
      "y": 300,
      "width": 32,
      "height": 32,
      "properties": {
        "name": "Village Elder",
        "dialog": "Welcome to Eden's Hollow! Explore the village and speak to the townspeople."
      }
    },
    {
      "name": "Chest1",
      "type": "chest",
      "x": 400,
      "y": 250,
      "width": 32,
      "height": 32,
      "properties": {
        "contents": ["potion", "coin"],
        "locked": false
      }
    }
  ]
}